21 21
~~~~~~~~~#.#~~~~~~~~~
~~~~~~~~~#.#~~~~~~~~~
~~~~~~~~~#.#~~~~~~~~~
~~~~~~~~~#.#~~~~~~~~~
~~~~~~~~~#.#~~~~~~~~~
~~~~~~~~~#.#~~~~~~~~~
~~~~~~####.####~~~~~~
~~~~~~#C.....C#~~~~~~
~#~#~##.......##~#~#~
.....................
..........@..........
#~#~#~#.......#~#~#~#
~~~~~~#C.....C#~~~~~~
......####.####......
.........#.#.........
.........#.#.........
.........#.#.........
.........#.#.........
.........#.#.........
.........#.#.........
.....................
