10 10
...~@#....
~~.......#
..#C..@..~
..@.#@.@..
~..~..@...
...~~.@#.@
.@....~~~.
~.#....#~.
...~@...~.
~.C@..@..#
