10 10
....@..~..
~#......~#
...C.~C~..
..@..C.#..
#....~...#
...~..~...
.....~~.#.
.....~~~~~
.#....#~..
..C@~.@..~
